{
	"slices": [
		[ "                ", "                ", "                ", "   ####  ####   ", "   ####  ####   ", "   ####  ####   ", "   ####  ####   ", "                ", "                ", "   ####  ####   ", "   ####  ####   ", "   ####  ####   ", "   ####  ####   ", "                ", "                ", "                " ],
		[ "                ", "                ", "                ", "   ####  ####   ", "   ####  ####   ", "   ####  ####   ", "   ####  ####   ", "                ", "                ", "   ####  ####   ", "   ####  ####   ", "   ####  ####   ", "   ####  ####   ", "                ", "                ", "                " ],
		[ "                ", "                ", "                ", "   ####  ####   ", "   ####  ####   ", "   ####  ####   ", "   ####  ####   ", "                ", "                ", "   ####  ####   ", "   ####  ####   ", "   ####  ####   ", "   ####  ####   ", "                ", "                ", "                " ],
		[ "                ", "                ", "                ", "   ####  ####   ", "   ####  ####   ", "   ####  ####   ", "   ####  ####   ", "                ", "                ", "   ####  ####   ", "   ####  ####   ", "   ####  ####   ", "   ####  ####   ", "                ", "                ", "                " ],
		[ "                ", "                ", "                ", "                ", "    :#    #:    ", "    #      #    ", "                ", "                ", "                ", "                ", "    #      #    ", "    :#    #:    ", "                ", "                ", "                ", "                " ],
		[ "                ", "                ", "                ", "                ", "    ::    ::    ", "    :      :    ", "                ", "                ", "                ", "                ", "    :      :    ", "    ::    ::    ", "                ", "                ", "                ", "                " ],
		[ "                ", "                ", "                ", "                ", "    ::    ::    ", "    :      :    ", "                ", "                ", "                ", "                ", "    :      :    ", "    ::    ::    ", "                ", "                ", "                ", "                " ],
		[ "                ", "                ", "                ", "                ", "    ::    ::    ", "    ::    ::    ", "                ", "                ", "                ", "                ", "    ::    ::    ", "    ::    ::    ", "                ", "                ", "                ", "                " ],
		[ "                ", "                ", "                ", "                ", "     :    :     ", "    ::    ::    ", "                ", "                ", "                ", "                ", "    ::    ::    ", "     :    :     ", "                ", "                ", "                ", "                " ],
		[ "                ", "                ", "                ", "                ", "     :    :     ", "    ::    ::    ", "                ", "                ", "                ", "                ", "    ::    ::    ", "     :    :     ", "                ", "                ", "                ", "                " ],
		[ "                ", "                ", "                ", "                ", "     ::::::     ", "    ::    ::    ", "    :      :    ", "    :      :    ", "    :      :    ", "    :      :    ", "    ::    ::    ", "     ::::::     ", "                ", "                ", "                ", "                " ],
		[ "                ", "                ", "                ", "                ", "                ", "     :    :     ", "                ", "                ", "                ", "                ", "     :    :     ", "                ", "                ", "                ", "                ", "                " ],
		[ "                ", "                ", "                ", "                ", "                ", "     :    :     ", "                ", "                ", "                ", "                ", "     :    :     ", "                ", "                ", "                ", "                ", "                " ],
		[ "                ", "                ", "                ", "                ", "                ", "     ::::::     ", "     :    :     ", "     :    :     ", "     :    :     ", "     :    :     ", "     ::::::     ", "                ", "                ", "                ", "                ", "                " ],
		[ "                ", "                ", "                ", "                ", "                ", "     ::  ::     ", "     ::  ::     ", "                ", "                ", "     ::  ::     ", "     ::  ::     ", "                ", "                ", "                ", "                ", "                " ],
		[ "                ", "                ", "                ", "                ", "                ", "     g    g     ", "      :  :      ", "                ", "                ", "      :  :      ", "     g    g     ", "                ", "                ", "                ", "                ", "                " ],
		[ "                ", "                ", "                ", "                ", "                ", "                ", "      ::::      ", "      :  :      ", "      :  :      ", "      ::::      ", "                ", "                ", "                ", "                ", "                ", "                " ],
		[ "                ", "                ", "                ", "                ", "                ", "                ", "      :  :      ", "                ", "                ", "      :  :      ", "                ", "                ", "                ", "                ", "                ", "                " ],
		[ "                ", "                ", "                ", "                ", "                ", "                ", "      ::::      ", "      :  :      ", "      :  :      ", "      ::::      ", "                ", "                ", "                ", "                ", "                ", "                " ],
		[ "                ", "                ", "                ", "                ", "                ", "                ", "      :  :      ", "                ", "                ", "      :  :      ", "                ", "                ", "                ", "                ", "                ", "                " ],
		[ "                ", "                ", "                ", "                ", "                ", "                ", "      ::::      ", "      :  :      ", "      :  :      ", "      ::::      ", "                ", "                ", "                ", "                ", "                ", "                " ],
		[ "                ", "                ", "                ", "                ", "                ", "                ", "      g  g      ", "       ::       ", "       ::       ", "      g  g      ", "                ", "                ", "                ", "                ", "                ", "                " ],
		[ "                ", "                ", "                ", "                ", "                ", "                ", "                ", "       ::       ", "       ::       ", "                ", "                ", "                ", "                ", "                ", "                ", "                " ],
		[ "                ", "                ", "                ", "                ", "                ", "                ", "                ", "       ::       ", "       ::       ", "                ", "                ", "                ", "                ", "                ", "                ", "                " ]
	],
	"xsize": 16,
	"zsize": 16
}