{
	"slices": [
		[ "#QQSSQQSSQQSSQQS", "#SSQQSSQQSSQQSSQ", "#SSQQSSQQSSQQSSQ", "#QQSSQQSSQQSSQQS", "#QQSSQQSSQQSSQQS", "#SSQQSSQQSSQQSSQ", "#SSQQSSQQSSQQSSQ", "#QQSSQQSSQQSSQQS", "#QQSSQQSSQQSSQQS", "#SSQQSSQQSSQQSSQ", "#SSQQSSQQSSQQSSQ", "#QQSSQQSSQQSSQQS", "#QQSSQQSSQQSSQQS", "#SSQQSSQQSSQQSSQ", "#SSQQSSQQSSQQSSQ", "################" ],
		[ "#               ", "#               ", "#               ", "#               ", "#               ", "#               ", "#               ", "#               ", "#               ", "#               ", "#               ", "#               ", "#               ", "#               ", "#               ", "################" ],
		[ "#               ", "#               ", "#               ", "#               ", "#               ", "#               ", "#               ", "#               ", "#               ", "#               ", "#               ", "#               ", "#               ", "#               ", "#               ", "################" ],
		[ "a               ", "#               ", "a               ", "a               ", "#               ", "a               ", "a               ", "#T              ", "a               ", "a               ", "#               ", "a               ", "a               ", "#               ", "#       T       ", "###aa#aa#aa#aa#a" ],
		[ "#               ", "#               ", "#               ", "#               ", "#               ", "#               ", "#               ", "#               ", "#               ", "#               ", "#               ", "#               ", "#               ", "#               ", "#               ", "################" ],
		[ "################", "################", "################", "################", "################", "################", "################", "################", "################", "################", "################", "################", "################", "################", "################", "################" ]
	],
	"xsize": 16,
	"zsize": 16
}