{
	"meta": [
		{
			"integer": 13,
			"key": "z1"
		},
		{
			"integer": 15,
			"key": "z2"
		}
	],
	"slices": [
		[ "  ", "  ", "  ", "__", "==", "  ", "  ", "  ", "  ", "  ", "  ", "  ", " T", " w", "  ", "  " ],
		[ "  ", "  ", "  ", "  ", "  ", "__", "==", "  ", "  ", "  ", "  ", "  ", "  ", " w", "  ", "  " ],
		[ "  ", "  ", "  ", "  ", "  ", "  ", "  ", "__", "==", "  ", "  ", "  ", "  ", " w", "  ", "  " ],
		[ "  ", "  ", "  ", "  ", "  ", "  ", "  ", "  ", "  ", "__", "==", "  ", "  ", " w", "  ", "  " ],
		[ "  ", "  ", "  ", "  ", "  ", "  ", "  ", "  ", "  ", "  ", "  ", "__", "==", " w", "  ", "  " ],
		[ "  ", "  ", "  ", "  ", "  ", "  ", "  ", "  ", "  ", "  ", "  ", "  ", "  ", "__", "__", "__" ]
	],
	"xsize": 2,
	"zsize": 16
}