{
	"palette": {
		"palette": [
			{
				"block": "minecraft:oak_planks",
				"char": "o"
			}
		]
	},
	"slices": [
		[ "                ", "                ", "     :          ", "   : : :        ", "                ", "  :: u ::       ", "                ", "   : : :        ", "     :          ", "                ", "                ", "                ", "                ", "                ", "                ", "                " ],
		[ "                ", "                ", "                ", "   : : :        ", "                ", "   : u :        ", "                ", "   : : :        ", "                ", "                ", "                ", "                ", "                ", "                ", "                ", "                " ],
		[ "                ", "                ", "                ", "   : : :        ", "                ", "   : u :        ", "                ", "   : : :        ", "                ", "                ", "                ", "                ", "                ", "                ", "                ", "                " ],
		[ "                ", "                ", "                ", "   _uuu_        ", "   uuuuu        ", "   uuuuu        ", "   uuuuu        ", "   _uuu_        ", "                ", "                ", "                ", "                ", "                ", "                ", "                ", "                " ],
		[ "                ", "                ", "                ", "    ooo         ", "   o   o        ", "   o   o        ", "   o   o        ", "    ooo         ", "                ", "                ", "                ", "                ", "                ", "                ", "                ", "                " ],
		[ "                ", "                ", "                ", "    uuu         ", "   u   u        ", "   u   u        ", "   u   u        ", "    uuu         ", "                ", "                ", "                ", "                ", "                ", "                ", "                ", "                " ],
		[ "                ", "                ", "                ", "    ccc         ", "   t   A        ", "   t   A        ", "   t   A        ", "    zzz         ", "                ", "                ", "                ", "                ", "                ", "                ", "                ", "                " ],
		[ "                ", "                ", "                ", "                ", "    tcA         ", "    tuA         ", "    tzz         ", "                ", "                ", "                ", "                ", "                ", "                ", "                ", "                ", "                " ]
	],
	"xsize": 16,
	"zsize": 16
}