{
	"slices": [
		[ "################", "##QSQSQSQSQSQSQ#", "#QSQSQSQSQSQSQSQ", "#SQSQSQSQSQSQSQS", "#QSQSQSQSQSQSQSQ", "#SQSQSQSQSQSQSQS", "#QSQSQSQSQSQSQSQ", "#SQSQSQSQSQSQSQS", "#QSQSQSQSQSQSQSQ", "#SQSQSQSQSQSQSQS", "#QSQSQSQSQSQS  Q", "#SQSQSQSQSQSQ  S", "#QSQSQSQSQSQS  Q", "#SQSQSQSQSQSQ  S", "#QSQSQSQSQSQS))Q", "##QSQSQSQSQSQSQS" ],
		[ "##::#########::#", "##             #", ":               ", ":               ", "#               ", "#               ", "#               ", "#               ", "#               ", "#            )) ", "#           Q  Q", "#           Q  Q", "#           Q  Q", ":           Q  Q", ":           Q  Q", "##              " ],
		[ "##::#########::#", "##             #", ":               ", ":               ", "#               ", "#               ", "#               ", "#               ", "#               ", "#               ", "#           a))a", "#           a  a", "#           a  a", ":           a  a", ":           a  a", "##              " ],
		[ "##::#########::#", "##             #", ":               ", ":               ", "#               ", "#               ", "#               ", "#               ", "#               ", "#               ", "#           a  a", "#           a))a", "#           a  a", ":           a  a", ":           a  a", "##              " ],
		[ "##::#########::#", "##             #", ":               ", ":               ", "#               ", "#               ", "#               ", "#               ", "#               ", "#               ", "#           a  a", "#           a  a", "#           a))a", ":           a  a", ":           a  a", "##              " ],
		[ "################", "################", "################", "################", "################", "################", "################", "################", "################", "################", "#############  #", "#############  #", "#############  #", "#############))#", "#############  #", "################" ]
	],
	"xsize": 16,
	"zsize": 16
}