{
	"slices": [
		[ "##SQSQSQSQSQSQSQ", "#SQSQSQSQSQSQSQS", "#QSQSQSQSQSQSQSQ", "#SQSQSQSQSQSQSQS", "#QSQSQSQSQSQSQSQ", "#SQSQSQSQSQSQSQS", "#QSQSQSQSQSQSQSQ", "#SQSQSQSQSQSQSQS", "#QSQSQSQSQSQSQSQ", "#SQSQSQSQSQSQSQS", "#QSQSQSQSQSQSQSQ", "#SQSQSQSQSQSQSQS", "#QSQSQSQSQSQSQSQ", "#SQSQSQSQSQSQSQS", "##SQSQSQSQSQSQS#", "################" ],
		[ "##              ", ":               ", ":               ", "#               ", "#               ", "#               ", "#               ", "#       T       ", "#               ", "#               ", "#               ", "#               ", ":               ", ":               ", "##             #", "##::#########::#" ],
		[ "##              ", ":               ", ":               ", "#               ", "#               ", "#               ", "#               ", "#               ", "#               ", "#               ", "#               ", "#               ", ":               ", ":               ", "##             #", "##::#########::#" ],
		[ "##              ", ":               ", ":               ", "#               ", "#               ", "#               ", "#               ", "#               ", "#               ", "#               ", "#               ", "#               ", ":               ", ":               ", "##             #", "##::#########::#" ],
		[ "##              ", ":               ", ":               ", "#               ", "#               ", "#               ", "#               ", "#               ", "#               ", "#               ", "#               ", "#               ", ":               ", ":               ", "##             #", "##::#########::#" ],
		[ "################", "################", "################", "################", "################", "################", "################", "################", "################", "################", "################", "################", "################", "################", "################", "################" ]
	],
	"xsize": 16,
	"zsize": 16
}